♠ ♠ ♥ ♥ ♦
♣ ♣ ♥ ♦ ♦
♣ ♥ ♥ ♥ ♦
♥ ♦ ♦ ♦ ♦
♠ ♥ ♥ ♦ ♦
♣ ♣ ♦ ♦ ♦
♠ ♠ ♠ ♦ ♦
♠ ♠ ♠ ♠ ♣
♣ ♦ ♦ ♦ ♦
♣ ♥ ♥ ♥ ♥
♠ ♥ ♦ ♦ ♦
♠ ♠ ♠ ♠ ♠
♠ ♠ ♠ ♠ ♦
♠ ♠ ♠ ♠ ♥
♠ ♣ ♥ ♥ ♥
♠ ♣ ♥ ♥ ♦
♠ ♠ ♥ ♥ ♥
♣ ♣ ♣ ♦ ♦
♠ ♣ ♣ ♣ ♣
♠ ♣ ♣ ♣ ♥
♠ ♣ ♣ ♣ ♦
♥ ♥ ♦ ♦ ♦
♣ ♥ ♦ ♦ ♦
♠ ♣ ♣ ♥ ♥
♠ ♠ ♣ ♥ ♥
♠ ♣ ♣ ♥ ♦
♠ ♠ ♣ ♣ ♦
♠ ♠ ♣ ♥ ♦
♠ ♠ ♣ ♣ ♣
♥ ♥ ♥ ♦ ♦
♠ ♠ ♣ ♣ ♥
♠ ♠ ♥ ♦ ♦
♠ ♠ ♠ ♥ ♦
♦ ♦ ♦ ♦ ♦
♠ ♠ ♠ ♥ ♥
♠ ♠ ♠ ♣ ♦
♠ ♠ ♠ ♣ ♥
♣ ♣ ♥ ♥ ♥
♠ ♥ ♥ ♥ ♥
♠ ♥ ♥ ♥ ♦
♣ ♣ ♥ ♥ ♦
♠ ♣ ♦ ♦ ♦
♣ ♥ ♥ ♦ ♦
♠ ♠ ♠ ♣ ♣
♠ ♠ ♦ ♦ ♦
♠ ♣ ♥ ♦ ♦
♠ ♦ ♦ ♦ ♦
♣ ♣ ♣ ♥ ♦
♣ ♣ ♣ ♣ ♥
♣ ♣ ♣ ♥ ♥
♣ ♣ ♣ ♣ ♦
♣ ♣ ♣ ♣ ♣
♠ ♣ ♣ ♦ ♦
♠ ♠ ♣ ♦ ♦
♥ ♥ ♥ ♥ ♦
♥ ♥ ♥ ♥ ♥
